0 0 0 0 0 0 0 0 0 0 0 0 0 0 0 0 0 0 0 0 0 0 0 0 0 0 0 0 0 0 0 0 0 0 0 0 0 0 0 0 0 0 0 0 0 0 0 0 0 0 0 0 0 0 0 0 0 0 0 0 0 0
0 0 0 0 0 0 0 0 0 0 0 0 0 0 0 0 0 0 0 0 0 0 0 0 0 0 0 0 0 0 0 0 0 0 0 0 0 0 0 0 0 0 0 0 0 0 0 0 0 0 0 0 0 0 0 0 0 0 0 0 0 0
0 0 0 0 0 0 0 0 0 0 0 0 0 0 0 0 0 0 0 0 0 0 0 0 0 0 0 0 0 0 0 0 0 0 0 0 0 0 0 0 0 0 0 0 0 0 0 0 0 0 0 0 0 0 0 0 0 0 0 0 0 0
0 0 0 0 0 0 0 0 0 0 0 0 0 0 0 0 0 0 0 0 0 0 0 0 0 0 0 0 0 0 0 0 0 0 0 0 0 0 0 0 0 0 0 0 0 0 0 0 0 0 0 0 0 0 0 0 0 0 0 0 0 0
0 0 0 0 0 0 0 0 0 0 0 0 0 0 0 0 0 0 0 0 0 0 0 0 0 0 0 0 0 0 0 0 0 0 0 0 0 0 0 0 0 0 0 0 0 0 0 0 0 0 0 0 0 0 0 0 0 0 0 0 0 0
0 0 0 0 0 0 0 0 0 0 0 0 0 0 0 0 0 0 0 0 0 0 0 0 0 0 0 0 0 0 0 0 0 0 0 0 0 0 0 0 0 0 0 0 0 0 0 0 0 0 0 0 0 0 0 0 0 0 0 0 0 0
0 0 0 0 0 0 4 4 4 4 4 4 4 4 4 4 4 4 4 4 4 4 4 4 4 4 4 4 4 4 4 4 4 4 4 4 4 4 4 4 4 4 4 4 4 4 4 4 4 4 4 4 4 4 4 4 0 0 0 0 0 0
0 0 0 0 0 0 4 1 1 1 1 1 4 3 3 3 3 3 3 3 3 3 3 3 3 3 3 3 3 3 3 3 3 3 3 3 3 3 3 3 3 3 3 3 3 3 3 3 3 3 3 3 3 3 3 4 0 0 0 0 0 0
0 0 0 0 0 0 4 1 3 3 3 1 4 5 4 4 4 4 4 4 4 4 4 4 4 4 4 4 4 4 4 4 4 4 4 4 4 4 4 4 4 4 4 4 4 4 4 4 4 4 4 4 4 4 3 4 0 0 0 0 0 0 
0 0 0 0 0 0 4 1 3 3 3 3 3 3 4 3 3 3 3 3 3 3 3 3 3 3 3 3 3 3 3 3 3 3 3 3 4 3 3 3 3 3 3 3 3 3 3 3 3 3 3 3 3 4 3 4 0 0 0 0 0 0 
0 0 0 0 0 0 4 1 3 3 3 1 4 4 4 4 4 4 4 4 4 4 4 4 4 4 5 4 4 4 4 4 4 4 4 4 4 4 4 4 4 4 4 4 5 4 4 4 4 4 4 4 3 4 3 4 0 0 0 0 0 0 
0 0 0 0 0 0 4 1 1 1 1 1 4 3 3 3 3 3 3 3 3 3 3 3 3 3 3 3 3 3 3 3 3 3 3 3 3 3 3 3 3 3 4 3 3 3 3 3 3 3 3 4 3 4 3 4 0 0 0 0 0 0 
0 0 0 0 0 0 4 4 4 4 4 4 4 5 4 4 4 4 4 4 4 4 4 5 4 4 4 4 4 4 4 4 4 4 4 4 4 4 4 4 4 4 4 4 4 4 4 4 4 4 3 4 3 4 3 4 0 0 0 0 0 0 
0 0 0 0 0 0 4 3 3 3 3 3 3 3 3 3 3 3 3 3 4 3 3 3 3 3 3 3 3 3 3 3 3 3 3 3 3 3 3 3 3 3 3 3 3 3 3 3 3 4 3 4 3 5 3 4 0 0 0 0 0 0 
0 0 0 0 0 0 4 3 4 4 4 4 4 4 5 4 4 4 4 4 4 4 4 4 4 4 4 4 4 4 5 4 4 4 4 4 4 4 4 4 2 2 2 4 4 4 4 4 3 4 3 4 3 4 3 4 0 0 0 0 0 0 
0 0 0 0 0 0 4 3 4 3 3 3 3 3 3 3 3 3 3 3 3 3 3 3 3 3 3 3 3 3 3 3 3 3 3 3 3 3 3 3 2 2 2 3 3 3 3 4 3 5 3 4 3 4 3 4 0 0 0 0 0 0 
0 0 0 0 0 0 4 3 4 3 4 4 4 4 4 4 4 4 4 4 4 4 4 4 4 4 4 5 4 4 4 4 4 4 5 4 4 4 4 4 2 2 2 4 4 4 3 4 3 4 3 4 3 4 3 4 0 0 0 0 0 0 
0 0 0 0 0 0 4 3 4 3 5 3 3 3 3 3 3 3 3 3 3 3 3 3 3 3 3 3 3 4 3 3 3 3 3 3 3 3 3 3 3 3 3 3 3 4 3 4 3 4 3 4 3 4 3 4 0 0 0 0 0 0 
0 0 0 0 0 0 4 3 5 3 4 3 4 4 4 4 4 4 4 5 4 4 4 4 4 4 4 4 4 4 4 5 4 4 4 4 4 4 4 4 4 4 4 4 3 4 3 4 3 4 3 4 3 4 3 4 0 0 0 0 0 0 
0 0 0 0 0 0 4 3 4 3 4 3 4 3 3 3 3 3 3 3 3 3 3 3 3 3 3 3 3 3 3 3 3 3 3 3 3 3 3 3 3 3 3 4 3 4 3 4 3 4 3 4 3 4 3 4 0 0 0 0 0 0 
0 0 0 0 0 0 4 3 4 3 4 3 4 4 4 4 4 4 4 4 4 4 4 4 4 4 4 4 5 4 4 4 4 4 4 4 4 5 4 4 4 4 4 4 3 5 3 4 3 4 3 4 3 4 3 4 0 0 0 0 0 0 
0 0 0 0 0 0 4 2 2 3 4 3 4 3 4 3 4 3 4 3 4 3 3 3 3 3 3 3 3 3 3 3 3 3 3 3 3 3 3 3 3 3 3 4 3 4 3 4 3 4 3 4 3 4 3 4 0 0 0 0 0 0 
0 0 0 0 0 0 4 2 2 3 4 3 4 3 4 3 4 3 4 3 4 3 4 4 4 5 4 4 4 5 4 4 4 4 4 4 4 4 4 5 4 4 3 4 3 4 3 4 3 4 3 4 3 4 3 4 0 0 0 0 0 0 
0 0 0 0 0 0 4 2 2 3 4 3 4 3 4 3 4 3 5 3 4 3 4 3 3 3 4 3 3 3 3 3 3 3 3 3 4 3 3 3 3 4 3 4 3 4 3 4 3 4 3 4 3 4 3 4 0 0 0 0 0 0 
0 0 0 0 0 0 4 3 4 3 4 3 4 3 4 3 4 3 4 3 4 3 4 3 4 4 4 4 5 4 4 4 4 5 4 4 4 4 4 4 3 4 3 4 3 4 3 4 3 4 3 4 3 4 3 4 0 0 0 0 0 0 
0 0 0 0 0 0 4 3 4 4 4 3 4 3 4 3 4 4 4 3 4 4 4 3 4 3 3 3 3 3 4 3 3 3 3 3 3 3 3 4 3 4 3 4 3 4 3 4 4 4 3 4 3 4 3 4 0 0 0 0 0 0 
0 0 0 0 0 0 4 3 4 3 4 3 4 3 5 3 4 3 4 3 4 3 4 3 4 3 4 4 4 4 4 4 4 4 4 5 4 4 3 5 3 4 3 4 3 4 3 4 3 4 3 4 3 4 3 4 0 0 0 0 0 0 
0 0 0 0 0 0 4 3 4 3 4 3 4 3 4 3 4 3 4 3 4 3 4 4 4 3 4 3 3 3 3 4 3 3 3 3 3 4 3 4 3 4 3 4 3 4 3 4 3 4 3 4 3 4 3 4 0 0 0 0 0 0 
0 0 0 0 0 0 4 3 5 3 4 3 4 3 4 3 4 3 4 3 4 3 4 3 4 3 5 3 4 4 4 4 4 5 4 4 3 4 3 4 3 4 3 4 3 4 3 4 3 4 3 4 3 4 3 4 0 0 0 0 0 0 
0 0 0 0 0 0 4 3 4 3 4 3 4 3 4 3 4 3 5 3 4 3 4 3 4 3 4 3 4 3 3 4 3 3 3 4 3 5 3 4 3 4 3 4 3 4 3 4 3 4 3 4 3 4 4 4 0 0 0 0 0 0 
0 0 0 0 0 0 4 3 4 3 4 3 4 3 4 3 4 3 4 3 4 3 4 3 5 3 4 3 5 3 4 4 5 4 3 4 3 4 3 4 4 4 3 4 3 4 3 4 3 4 3 4 3 4 3 4 0 0 0 0 0 0 
0 0 0 0 0 0 4 3 4 3 5 3 4 3 4 3 4 3 4 3 4 3 5 3 4 3 4 3 4 3 5 5 5 4 4 4 4 4 3 5 3 4 3 4 3 4 3 4 3 4 3 4 3 4 3 4 0 0 0 0 0 0 
0 0 0 0 0 0 4 3 4 3 4 3 4 3 4 3 4 3 4 3 4 3 4 3 4 3 4 3 4 4 4 5 5 5 3 4 3 4 3 4 3 4 3 4 3 4 3 4 3 4 3 4 3 4 3 4 0 0 0 0 0 0 
0 0 0 0 0 0 4 3 4 3 4 3 4 3 4 3 4 3 4 3 4 3 4 3 4 3 4 3 4 3 4 5 4 4 3 5 3 4 3 4 3 4 3 4 3 4 3 4 3 4 3 5 3 4 3 4 0 0 0 0 0 0 
0 0 0 0 0 0 4 3 4 3 4 3 4 3 4 3 4 3 4 3 4 3 4 4 4 3 4 3 4 3 3 3 4 3 3 4 3 4 3 4 3 5 3 4 3 4 3 5 3 4 3 4 3 4 3 4 0 0 0 0 0 0 
0 0 0 0 0 0 4 3 4 3 4 3 4 3 4 4 4 3 4 4 4 3 4 3 4 3 4 3 4 4 5 4 4 4 4 4 3 5 3 4 3 4 3 4 3 4 3 4 3 4 3 4 3 4 3 4 0 0 0 0 0 0 
0 0 0 0 0 0 4 3 4 3 4 3 4 3 4 3 4 3 4 3 4 3 5 3 4 3 4 3 3 3 3 3 3 3 3 3 3 4 3 4 3 4 3 4 3 4 3 4 3 4 3 4 3 4 3 4 0 0 0 0 0 0 
0 0 0 0 0 0 4 3 4 3 4 3 4 3 4 3 4 3 4 3 4 3 4 3 4 3 4 4 4 4 4 5 4 4 4 4 4 4 3 4 3 4 3 4 3 4 3 4 3 2 2 2 3 4 3 4 0 0 0 0 0 0 
0 0 0 0 0 0 4 3 4 3 4 3 4 3 4 3 4 3 4 3 4 3 4 3 4 3 3 3 3 3 3 3 3 3 3 4 3 3 3 4 4 4 3 4 3 4 3 4 3 2 2 2 3 4 3 4 0 0 0 0 0 0 
0 0 0 0 0 0 4 3 4 3 4 3 4 3 5 3 4 3 4 3 4 3 4 3 4 4 5 4 4 4 4 4 4 4 4 4 4 4 4 4 3 5 3 4 3 4 3 4 3 2 2 2 3 4 3 4 0 0 0 0 0 0 
0 0 0 0 0 0 4 3 4 4 4 3 4 3 4 3 4 3 4 3 4 4 4 3 3 3 3 3 3 3 3 3 3 3 3 4 3 3 3 3 3 4 3 4 3 4 3 4 3 4 3 4 3 5 3 4 0 0 0 0 0 0 
0 0 0 0 0 0 4 3 4 3 4 3 4 3 4 3 4 3 4 3 4 3 4 4 4 4 4 4 4 4 4 5 4 4 4 4 4 4 4 4 4 4 3 4 3 4 3 4 3 4 3 4 3 4 3 4 0 0 0 0 0 0 
0 0 0 0 0 0 4 3 4 3 4 3 4 3 4 3 4 3 5 3 4 3 3 3 3 3 3 3 3 3 3 3 3 3 3 3 3 3 4 3 3 3 3 4 3 4 3 4 3 4 3 4 3 4 3 4 0 0 0 0 0 0 
0 0 0 0 0 0 4 3 4 3 4 3 4 3 4 3 4 3 4 3 4 4 5 4 4 4 4 4 4 4 4 4 4 4 4 4 4 5 4 4 4 4 4 4 3 4 3 4 3 5 3 4 3 4 3 4 0 0 0 0 0 0 
0 0 0 0 0 0 4 3 4 3 4 3 4 4 4 3 4 3 4 3 3 3 3 3 3 3 3 4 3 3 3 3 3 3 3 3 3 3 3 3 3 3 3 3 3 4 3 4 3 4 3 4 4 4 3 4 0 0 0 0 0 0 
0 0 0 0 0 0 4 3 4 3 4 3 4 3 4 3 4 3 4 4 4 4 4 4 4 4 4 4 4 4 4 5 4 4 4 4 4 4 4 4 4 4 5 4 4 4 3 4 3 4 3 4 3 4 3 4 0 0 0 0 0 0 
0 0 0 0 0 0 4 3 4 3 4 3 4 3 4 3 4 3 3 3 3 3 3 3 4 3 3 3 3 3 3 3 3 3 3 3 3 3 3 3 3 3 3 3 3 3 3 4 3 4 3 4 3 4 3 4 0 0 0 0 0 0 
0 0 0 0 0 0 4 3 5 3 4 3 4 3 4 3 4 4 4 4 4 4 4 4 4 4 4 4 4 4 4 4 4 4 4 4 4 5 4 4 4 4 4 4 4 4 4 4 3 4 3 4 3 5 3 4 0 0 0 0 0 0 
0 0 0 0 0 0 4 3 4 3 4 3 4 3 4 3 3 3 3 3 3 3 3 3 3 3 3 3 3 3 3 3 3 3 3 3 3 3 3 3 3 3 3 4 3 3 3 3 3 4 3 4 3 4 3 4 0 0 0 0 0 0 
0 0 0 0 0 0 4 3 4 3 4 3 4 3 4 4 4 4 5 4 4 4 2 2 2 4 4 4 4 4 4 4 4 4 4 4 4 4 4 4 4 4 4 4 4 4 4 4 4 4 3 4 3 4 3 4 0 0 0 0 0 0 
0 0 0 0 0 0 4 3 4 3 5 3 4 3 3 3 3 3 3 3 3 3 2 2 2 3 3 3 3 3 3 3 3 3 3 3 3 4 3 3 3 3 3 3 3 3 3 3 3 3 3 4 3 4 4 4 0 0 0 0 0 0 
0 0 0 0 0 0 4 3 4 3 4 3 4 4 4 5 4 4 4 4 4 4 2 2 2 4 4 4 4 4 4 4 4 4 4 4 4 4 4 4 4 4 4 4 4 4 4 4 5 4 4 2 2 2 2 4 0 0 0 0 0 0 
0 0 0 0 0 0 4 3 4 3 4 3 3 3 3 3 3 3 3 3 3 3 3 3 3 3 3 3 3 3 4 3 3 3 3 3 3 3 3 3 3 3 3 3 3 3 3 3 3 3 3 2 2 2 2 4 0 0 0 0 0 0 
0 0 0 0 0 0 4 3 4 4 4 4 4 4 4 4 4 4 4 4 4 4 4 4 4 5 4 4 4 4 4 4 4 4 4 4 4 5 4 4 4 4 4 4 4 4 4 4 4 5 4 2 2 2 2 4 0 0 0 0 0 0 
0 0 0 0 0 0 4 3 3 4 3 3 3 3 3 3 3 3 3 3 3 3 3 3 3 3 3 3 3 3 3 3 3 3 3 3 3 3 3 3 3 4 3 3 3 3 3 3 3 3 4 2 2 2 2 4 0 0 0 0 0 0 
0 0 0 0 0 0 4 4 4 4 4 4 4 4 4 4 4 4 4 4 4 4 4 4 4 4 4 4 4 4 4 4 4 4 4 4 4 4 4 4 4 4 4 4 4 4 4 4 4 4 4 4 4 4 4 4 0 0 0 0 0 0 
0 0 0 0 0 0 0 0 0 0 0 0 0 0 0 0 0 0 0 0 0 0 0 0 0 0 0 0 0 0 0 0 0 0 0 0 0 0 0 0 0 0 0 0 0 0 0 0 0 0 0 0 0 0 0 0 0 0 0 0 0 0
0 0 0 0 0 0 0 0 0 0 0 0 0 0 0 0 0 0 0 0 0 0 0 0 0 0 0 0 0 0 0 0 0 0 0 0 0 0 0 0 0 0 0 0 0 0 0 0 0 0 0 0 0 0 0 0 0 0 0 0 0 0
0 0 0 0 0 0 0 0 0 0 0 0 0 0 0 0 0 0 0 0 0 0 0 0 0 0 0 0 0 0 0 0 0 0 0 0 0 0 0 0 0 0 0 0 0 0 0 0 0 0 0 0 0 0 0 0 0 0 0 0 0 0
0 0 0 0 0 0 0 0 0 0 0 0 0 0 0 0 0 0 0 0 0 0 0 0 0 0 0 0 0 0 0 0 0 0 0 0 0 0 0 0 0 0 0 0 0 0 0 0 0 0 0 0 0 0 0 0 0 0 0 0 0 0
0 0 0 0 0 0 0 0 0 0 0 0 0 0 0 0 0 0 0 0 0 0 0 0 0 0 0 0 0 0 0 0 0 0 0 0 0 0 0 0 0 0 0 0 0 0 0 0 0 0 0 0 0 0 0 0 0 0 0 0 0 0
0 0 0 0 0 0 0 0 0 0 0 0 0 0 0 0 0 0 0 0 0 0 0 0 0 0 0 0 0 0 0 0 0 0 0 0 0 0 0 0 0 0 0 0 0 0 0 0 0 0 0 0 0 0 0 0 0 0 0 0 0 0